"Room Number","Is Occupied","Room Rate","Customer ID","Customer Details"
"101","N",,,
"102","N",,,
"103","N",,,
"104","N",,,
"105","N",,,
"106","N",,,
"107","N",,,
"108","N",,,
"109","N",,,
"110","N",,,
"111","N",,,
"112","N",,,
"113","N",,,
"114","N",,,
"115","N",,,
"116","N",,,
"117","N",,,
"118","N",,,
"119","N",,,
"120","N",,,
"121","N",,,
"122","N",,,
"123","N",,,
"124","N",,,
"125","N",,,
